--------------************----------------###############-------------------------------------------
----------------**********-----------------###########----------------------------------------------
-------------------*****----------------------####--------------------------------------------------
----------------------------------------------------------------------------------------------------
----------|||||||||||----------------------------------------------************---------------------
--------|||||||||||||||||-----------------------------------------********,,*****-------------------
---------|||||||||||||||||----------------------------------------******,,,,******------------------
----------||||||||||||||||-----------------------------------------*******,,,******-----------------
-----------|||||||||||||---------------------------------------------*******,,******----------------
-------------|||||||||-------------------------------------------------******,******----------------
---------------|||||-----------------------------------------------------**********-----------------
----------------------------------------------------------------------------------------------------
----------------------------------------------------------------------------------------------------
----------------------------------------------------------------------------------------------------
----------------------------------------------------------------------------------------------------
----------------------------------------------------------------------------------------------------
-----------------------------------*******-----------------------------------------------------#####
#######-----------------------****************--------------------------------------------##########
##########-----------------**********************--------------------------------------#############
--##########-------------*********,,,,,,,,*********---------------------------------############----
----#########------------*******,,,,,,,,,,,,,********----------------------------#############------
-----#########-----------*******,,,,,,,,,,,,,,********------------------------###############-------
---###########-----------********,,,,,,,,,,,,,*********---------------------#####################---
##############-------------*****************************-------------------#########################
#############----------------****************************------------------#########################
-#########-------------------------***********************-----------------#####################----
------------------------------------------*****************------------------##########-------------
----------------------------------------------**************----------------------------------------
-------------------------------------------------************---------------------------------------
-------------------------------------------------------***--------------|||||-----------------------
*****-----------------------#########--------------------------------||||||||||---------------******
**********----------------###############--------------------------||||||||||||||----------*********
,,,*********--------------###################-----------------------|||||||||||||--------*********,,
,,,,,,********-------------######################-------------------|||||||||||||||-----********,,,,
,,,,,,,,********------------##########################----------------||||||||----------*******,,,,,
,,,,,,,,*********------------##############################--------------|||------------********,,,,
,,,,,,,***********-------------###############################---------------------------*********,,
********************--------------#############################---------------------------**********
*********************---------------###########################------------------------------*******
------*****************----------------######################---------------------------------------